11111111111111111111
10000CC00C1110100001
1E100CC00C0000C00001
10000000001C00P00001
111C0000000000000001
1000100C00010C00C001
10000000C000000C0001
10000000C000000C0001
10000000C000000C0001
10000000C000000C0001
10000000C000000C0001
10000000C000000C0001
10000000C000000C0001
10000000C000000C0001
10000000C000000C0001
10000000C000000C0001
10000000C000000C0001
10000000C000000C0001
10000000C000000C0001
11111111111111111111