111111111111
100000000001
10C000P00001
10C0000000C1
1E000C000001
100000000001
100000000001
100000000001
111111111111
111111111111
111111111111
111111111111