11111111
10000001
10000001
10E00001
1C0P0001
11111111