11111
10C01
10CP1
10E01
10001
11111