1111111111111
100100C0C0CE1
1000P0CC00001
11100000100C1
1000001C00001
1111000000011
11C0000C00011
1000000000001
1000000000001
110000CCC0001
1111111111111