111111
10C101
1E0001
100CP1
111111